################################################################################
#......#...........#..................#....##........#.......#........#........#
#......#..........###.................#.....##.......#.......#........#........#
#......#..............................#......###.....#.......#........#........#
#......#.....##############.........####.............#.......####.....#####....#
#......#.....#.......................................#..........#..............#
#......#.....#.......................................#..........#..............#
#......#######.......###########################.....#..........#####.......####
#....................#                         #.....#.....#...................#
#....................#                         #...........#...................#
#....####............#                         #...........#...................#
#.......#####........#                         #..................##############
#....................#                         #.....#.....................#####
#.....###.......######                         #.....#........####.............#
#....................#                         #.....#........#..#.............#
#......#######.......###########################.....#...........#.............#
#.........#................#.........................#...........########......#
#.........#................#................#........#......#..................#
#.........#.........###....#........#########........#......#..................#
#.........#...........#...................#..........#......#..................#
#.........#...........#...................#..........#......#..................#
#.........#...........#...................#..........#......#..................#
#.........#...........#...................#..........#......#..................#
################################################################################
